        ╔════════════════════════════════════════════════════╗                                                        ╔═════════════════════════════╗
        ║                                                    ║                                                        ║                             ║
        ║                                      wwwwwwwwww    ║                                                        ║                             ║
        ║                           ░░░░░     wwwwwwwwww     ║                                                        ║          ░░░░░░░░░░░░░░░░░  ║
        ║                                    wwwwwwwwwww     ║                                                        ║          ░░░░░░░░░░░░░░░░░  ║
        ║                                                    ║                                                        ║          ░░░░░░░░░░░░░░░░░  ║
        ║                                                    ║                                                        ║                             ║
        ║                                                    ║                                                        ║                             ║
        ║                                                    ║                             ╔══════════════════════════╝                             ║
        ║                                   ░░░░             ║                             ║                                                        ║
        ║                                                    ║                             ║   ~~~~~~~~~                        ***                 ║
        ║  ░░░░░                                             ║                             ║   ~~~~~~~~~~~~                     ****                ║
        ║  ░░░░░                                             ╚══════════════════╗          ║  ~~~~~~~~~~                        *****               ║
        ║  ░░░░░                                                                ║          ║                                    *****               ║
        ║  ░░░░░                                             ╔═══════════════╗  ║          ║                                    *****               ║
        ║  ░░░░░                               ░░░░░         ║               ║  ║          ║                                      #                 ║
        ║  ░░░░░                            ░░░░░░░░░░       ║               ║  ║          ║                                                        ║ 
        ║                   ░░░░░░░░░░░░░░░░░░░░░░░░░░░░░░░░░║               ║  ╚══════════╝                                                        ║
        ║                                                    ║               ║                                                                      ║
        ║                                                    ║               ╚══════════════════════════════════════════════════════════════════════╝
        ╚════════════════════════════════════════════════════╝

        ╚════════╝╚════════╝╚════════╝╚════════╝╚════════╝╚════════╝╚════════╝╚════════╝╚════════╝╚════════╝╚════════╝╚════════╝╚════════╝╚════════╝║