        ╔════════════════════════════════════════════════════╗
        ║                                                    ║
        ║                                                    ║
        ║                                                    ║
        ║                                                    ║
        ║                                                    ║
        ║                                                    ║
        ║                                                    ║
        ║                                                    ║
        ║                                                    ║
        ║                                                    ║
        ║  ░░░░░                                             ║
        ║  ░░░░░                                             ║
        ║  ░░░░░                                             ║
        ║  ░░░░░                                             ║
        ║  ░░░░░                               ░░░░░         ║
        ║  ░░░░░                            ░░░░░░░░░░       ║
        ║░░░░░░░░░░░░░░░░░░░░░░░░░░░░░░░░░░░░░░░░░░░░░░░░░░░░║
        ╚════════════════════════════════════════════════════╝