        ╔════════════════════════════════════════════════════╗
        ║                                                    ║
        ║                                                    ║
        ║                           ░░░░░                    ║
        ║                                                    ║
        ║                                                    ║
        ║                                                    ║
        ║                                                    ║
        ║                                                    ║
        ║                                   ░░░░             ║
        ║                                                    ║
        ║  ░░░░░                                             ║
        ║  ░░░░░                                             ║
        ║  ░░░░░                                             ║
        ║  ░░░░░                                             ║
        ║  ░░░░░                               ░░░░░         ║
        ║  ░░░░░                            ░░░░░░░░░░       ║
        ║                   ░░░░░░░░░░░░░░░░░░░░░░░░░░░░░░░░░║
        ║                                                    ║
        ║                                                    ║
        ╚════════════════════════════════════════════════════╝